Job Title: Bus and Truck Mechanics and Diesel Engine Specialists
O*NET-SOC Code: 49-3031.00

# DESCRIPTION
Diagnose, adjust, repair, or overhaul buses and trucks, or maintain and repair any type of diesel engines. Includes mechanics working primarily with automobile or marine diesel engines.

# TASKS
- Use handtools, such as screwdrivers, pliers, wrenches, pressure gauges, or precision instruments, as well as power tools, such as pneumatic wrenches, lathes, welding equipment, or jacks and hoists.
- Inspect brake systems, steering mechanisms, wheel bearings, and other important parts to ensure that they are in proper operating condition.
- Raise trucks, buses, and heavy parts or equipment using hydraulic jacks or hoists.
- Adjust and reline brakes, align wheels, tighten bolts and screws, and reassemble equipment.
- Attach test instruments to equipment, and read dials and gauges to diagnose malfunctions.
- Perform routine maintenance such as changing oil, checking batteries, and lubricating equipment and machinery.
- Examine and adjust protective guards, loose bolts, and specified safety devices.
- Inspect, test, and listen to defective equipment to diagnose malfunctions, using test instruments such as handheld computers, motor analyzers, chassis charts, or pressure gauges.
- Rewire ignition systems, lights, and instrument panels.
- Test drive trucks and buses to diagnose malfunctions or to ensure that they are working properly.
- Diagnose and repair vehicle heating and cooling systems.
- Inspect, repair, and maintain automotive and mechanical equipment and machinery, such as pumps and compressors.
- Inspect and verify dimensions and clearances of parts to ensure conformance to factory specifications.
- Disassemble and overhaul internal combustion engines, pumps, generators, transmissions, clutches, and differential units.
- Adjust or repair computer controlled exhaust emissions devices.
- Rebuild gas or diesel engines.
- Specialize in repairing and maintaining parts of the engine, such as fuel injection systems.
- Recondition and replace parts, pistons, bearings, gears, and valves.
- Install or repair accessories.
- Repair or adjust seats, doors, or windows.
- Dismount, mount, and repair or replace tires.
- Align front ends and suspension systems.
- Maintain or repair vehicles with alternative fuel systems, including biodiesel, hybrid, or compressed natural gas vehicles.
- Measure vehicle emissions to determine whether they are within acceptable limits.
- Follow green operational practices involving conservation of water or energy or reduction of solid waste.
- Operate valve-grinding machines to grind and reset valves.

# SKILLS
(Scale definitions: Importance is rated 1-5. Level is rated 0-7.)
- Troubleshooting (Importance: 4.0/5 | Level: 3.75/7)
- Repairing (Importance: 4.0/5 | Level: 3.88/7)
- Operations Monitoring (Importance: 3.5/5 | Level: 3.25/7)
- Equipment Maintenance (Importance: 3.38/5 | Level: 3.38/7)
- Quality Control Analysis (Importance: 3.25/5 | Level: 3.25/7)
- Critical Thinking (Importance: 3.25/5 | Level: 3.38/7)
- Speaking (Importance: 3.12/5 | Level: 3.0/7)
- Judgment and Decision Making (Importance: 3.12/5 | Level: 3.0/7)
- Equipment Selection (Importance: 3.12/5 | Level: 3.0/7)
- Time Management (Importance: 3.0/5 | Level: 2.88/7)
- Complex Problem Solving (Importance: 3.0/5 | Level: 3.0/7)
- Monitoring (Importance: 3.0/5 | Level: 3.0/7)
- Active Listening (Importance: 3.0/5 | Level: 3.0/7)
- Operation and Control (Importance: 3.0/5 | Level: 3.12/7)
- Systems Analysis (Importance: 2.88/5 | Level: 2.5/7)
- Coordination (Importance: 2.88/5 | Level: 2.88/7)
- Reading Comprehension (Importance: 2.88/5 | Level: 2.88/7)
- Systems Evaluation (Importance: 2.75/5 | Level: 2.38/7)
- Social Perceptiveness (Importance: 2.75/5 | Level: 2.75/7)
- Active Learning (Importance: 2.75/5 | Level: 2.88/7)
- Learning Strategies (Importance: 2.75/5 | Level: 2.62/7)
- Writing (Importance: 2.62/5 | Level: 2.75/7)
- Service Orientation (Importance: 2.12/5 | Level: 2.12/7)
- Instructing (Importance: 2.12/5 | Level: 2.75/7)
- Installation (Importance: 2.12/5 | Level: 1.88/7)
- Persuasion (Importance: 2.0/5 | Level: 2.25/7)
- Negotiation (Importance: 2.0/5 | Level: 2.0/7)
- Mathematics (Importance: 2.0/5 | Level: 2.0/7)
- Management of Personnel Resources (Importance: 2.0/5 | Level: 2.0/7)
- Programming (Importance: 1.88/5 | Level: 1.12/7)
- Operations Analysis (Importance: 1.88/5 | Level: 1.12/7)
- Management of Material Resources (Importance: 1.88/5 | Level: 0.88/7)
- Management of Financial Resources (Importance: 1.88/5 | Level: 0.88/7)
- Technology Design (Importance: 1.88/5 | Level: 0.88/7)
- Science (Importance: 1.75/5 | Level: 1.25/7)

# TECHNOLOGY SKILLS & TOOLS
- Autodesk AutoCAD (Tech skill type: Computer aided design CAD software)
- Computer aided design CAD software (Tech skill type: Computer aided design CAD software)
- Computer aided manufacturing CAM software (Tech skill type: Computer aided manufacturing CAM software)
- Computerized maintenance management system software CMMS (Tech skill type: Facilities management software)
- Cummins INSITE (Tech skill type: Analytical or scientific software)
- Dassault Systemes CATIA (Tech skill type: Computer aided design CAD software)
- Dassault Systemes SolidWorks (Tech skill type: Computer aided design CAD software)
- Database software (Tech skill type: Data base user interface and query software)
- Engine diagnostic software (Tech skill type: Analytical or scientific software)
- Fleet management software (Tech skill type: Materials requirements planning logistics and supply chain software)
- Inventory tracking software (Tech skill type: Inventory management software)
- Microsoft Excel (Tech skill type: Spreadsheet software)
- Microsoft Office software (Tech skill type: Office suite software)
- Microsoft Word (Tech skill type: Word processing software)
- SAP software (Tech skill type: Enterprise resource planning ERP software)
- Scheduling software (Tech skill type: Calendar and scheduling software)
- Shop management software (Tech skill type: Facilities management software)
- Word processing software (Tech skill type: Word processing software)

## TOOLS USED
- Acetylene torches (Tool type: Blow torch)
- Adjustable crescent wrenches (Tool type: Adjustable wrenches)
- Adjustable widemouth pliers (Tool type: Adjustable widemouth pliers)
- Adjustable wrenches (Tool type: Adjustable wrenches)
- Ball peen hammers (Tool type: Ball peen hammer)
- Battery chargers (Tool type: Battery chargers)
- Bearing heating ovens (Tool type: Induction heaters)
- Blast cleaning cabinets (Tool type: Pneumatic sanding machines)
- Bleeder wrenches (Tool type: Specialty wrenches)
- Blow guns (Tool type: Compressed air gun)
- Bore gauges (Tool type: Hole gauge)
- Boring bars (Tool type: Boring machines)
- Boring tools (Tool type: Boring machines)
- Box end wrenches (Tool type: Box end wrenches)
- Brake shoe adjusting tools (Tool type: Brake repair kits)
- Brass drifts (Tool type: Punches or nail sets or drifts)
- Brass hammers (Tool type: Hammers)
- Brazing equipment (Tool type: Welder torch)
- Chain slings (Tool type: Slings)
- Claw hammers (Tool type: Claw hammer)
- Cold chisels (Tool type: Cold chisels)
- Combination wrenches (Tool type: Combination wrenches)
- Cross peen hammers (Tool type: Cross and straight pein hammer)
- Cutting torches (Tool type: Blow torch)
- Decelerometers (Tool type: Speed sensors)
- Depth gauges (Tool type: Depth gauges)
- Desktop computers (Tool type: Desktop computers)
- Detroit diesel electronic control DDEC readers (Tool type: Portable data input terminals)
- Diagonal cutting pliers (Tool type: Diagonal cut pliers)
- Dial calipers (Tool type: Calipers)
- Dial gauges (Tool type: Dial indicator or dial gauge)
- Drill machines (Tool type: Power drills)
- Drill presses (Tool type: Drill press or radial drill)
- Dynanometers (Tool type: Dynamometers)
- Feeler gauges (Tool type: Feeler gauges)
- Flare nut wrenches (Tool type: Specialty wrenches)
- Flash card readers (Tool type: Portable data input terminals)
- Forklifts (Tool type: Forklifts)
- Fuel pump test stands (Tool type: Engine or component test stands)
- Gas welding equipment (Tool type: Gas welding or brazing or cutting apparatus)
- Governor test stands (Tool type: Engine or component test stands)
- Grinding machines (Tool type: Power grinders)
- Hacksaws (Tool type: Hacksaw)
- Handheld diagnostic computers (Tool type: Portable data input terminals)
- Hearing protectors (Tool type: Ear plugs)
- Hex keys (Tool type: Hex keys)
- Hoists (Tool type: Hoists)
- Hones (Tool type: Automotive honing machine)
- Hydraulic pumps (Tool type: Hydraulic pumps)
- Hydraulic rams (Tool type: Hydraulic pumps)
- Impact wrenches (Tool type: Impact wrenches)
- Injector pop testers (Tool type: Pressure sensors)
- Inside calipers (Tool type: Calipers)
- Jacks (Tool type: Jacks)
- Lathes (Tool type: Tracer or duplicating or contouring lathe)
- Locking pliers (Tool type: Locking pliers)
- Metal inert gas MIG welders (Tool type: Metal inert gas welding machine)
- Micrometers (Tool type: Micrometers)
- Milling machines (Tool type: Milling machines)
- Multimeters (Tool type: Multimeters)
- Needlenose pliers (Tool type: Needlenose pliers)
- Open end wrenches (Tool type: Open end wrenches)
- Outside calipers (Tool type: Calipers)
- Paint spray guns (Tool type: Paint sprayers)
- Personal computers (Tool type: Personal computers)
- Pneumatic wrenches (Tool type: Pneumatic impact wrenches)
- Portable welding equipment (Tool type: Spot welding machine)
- Power drills (Tool type: Power drills)
- Power grinders (Tool type: Power grinders)
- Power sanders (Tool type: Power sanders)
- Power saws (Tool type: Power saws)
- Pressure gauges (Tool type: Pressure indicators)
- Pry bars (Tool type: Pry bars)
- Pump wrenches (Tool type: Specialty wrenches)
- Punch presses (Tool type: Drill press or radial drill)
- Punch sets (Tool type: Punches or nail sets or drifts)
- Punches (Tool type: Stamping dies or punches)
- Putty knives (Tool type: Putty knives)
- Rat tail files (Tool type: Round file)
- Ratchets (Tool type: Ratchets)
- Reamers (Tool type: Hand reamer)
- Riveting tools (Tool type: Rivet tools)
- Safety glasses (Tool type: Safety glasses)
- Safety gloves (Tool type: Protective gloves)
- Screwdrivers (Tool type: Screwdrivers)
- Shears (Tool type: Shears)
- Shielded arc welding tools (Tool type: Shielded metal arc welding or stick welding machine)
- Single-cut mill saw files (Tool type: Mill saw file)
- Sledgehammers (Tool type: Sledge hammer)
- Slip joint pliers (Tool type: Slip or groove joint pliers)
- Slug wrenches (Tool type: Specialty wrenches)
- Snap gauges (Tool type: Thickness measuring devices)
- Snap ring pliers (Tool type: Retaining ring pliers)
- Socket wrench sets (Tool type: Socket sets)
- Spark plug gapping tools (Tool type: Feeler gauges)
- Spark plug sockets (Tool type: Spark plug wrench)
- Steam cleaning equipment (Tool type: Pressure or steam cleaners)
- Tachometers (Tool type: Tachometers)
- Tape measures (Tool type: Tape measures)
- Test lights (Tool type: Circuit tester)
- Tire pressure gauges (Tool type: Tire pressure gauge)
- Torque wrenches (Tool type: Torque wrenches)
- Tungsten inert gas TIG welding equipment (Tool type: Tungsten inert gas welding machine)
- Two way radios (Tool type: Two way radios)
- Utility knives (Tool type: Utility knives)
- Vacuum pumps (Tool type: Vacuum pumps)
- Valve seat grinders (Tool type: Valve refacer)
- Vise grip pliers (Tool type: Locking pliers)
- Voltmeters (Tool type: Voltage or current meters)
- Water pump pliers (Tool type: Adjustable widemouth pliers)
- Welding hoods (Tool type: Welding masks)
- Wheel balancers (Tool type: Wheel balancing equipment)
- Wire crimpers (Tool type: Wire lug crimping tool)
- Wire cutting tools (Tool type: Wire cutters)
- Wire strippers (Tool type: Stripping tools)
- Workshop cranes (Tool type: Workshop cranes)