Job Title: First-Line Supervisors of Construction Trades and Extraction Workers
O*NET-SOC Code: 47-1011.00

# DESCRIPTION
Directly supervise and coordinate activities of construction or extraction workers.

# TASKS
- Inspect work progress, equipment, or construction sites to verify safety or to ensure that specifications are met.
- Read specifications, such as blueprints, to determine construction requirements or to plan procedures.
- Supervise, coordinate, or schedule the activities of construction or extractive workers.
- Assign work to employees, based on material or worker requirements of specific jobs.
- Coordinate work activities with other construction project activities.
- Estimate material or worker requirements to complete jobs.
- Analyze worker or production problems and recommend solutions, such as improving production methods or implementing motivational plans.
- Order or requisition materials or supplies.
- Train workers in construction methods, operation of equipment, safety procedures, or company policies.
- Locate, measure, and mark site locations or placement of structures or equipment, using measuring and marking equipment.
- Confer with managerial or technical personnel, other departments, or contractors to resolve problems or to coordinate activities.
- Arrange for repairs of equipment or machinery.
- Provide assistance to workers engaged in construction or extraction activities, using hand tools or other equipment.
- Record information, such as personnel, production, or operational data on specified forms or reports.
- Suggest or initiate personnel actions, such as promotions, transfers, or hires.

# SKILLS
(Scale definitions: Importance is rated 1-5. Level is rated 0-7.)
- Coordination (Importance: 3.88/5 | Level: 3.88/7)
- Speaking (Importance: 3.75/5 | Level: 3.75/7)
- Active Listening (Importance: 3.75/5 | Level: 3.62/7)
- Critical Thinking (Importance: 3.62/5 | Level: 3.38/7)
- Management of Personnel Resources (Importance: 3.62/5 | Level: 3.88/7)
- Time Management (Importance: 3.38/5 | Level: 3.5/7)
- Reading Comprehension (Importance: 3.38/5 | Level: 3.62/7)
- Monitoring (Importance: 3.38/5 | Level: 3.38/7)
- Judgment and Decision Making (Importance: 3.25/5 | Level: 3.12/7)
- Complex Problem Solving (Importance: 3.12/5 | Level: 3.25/7)
- Social Perceptiveness (Importance: 3.12/5 | Level: 3.38/7)
- Learning Strategies (Importance: 3.12/5 | Level: 3.0/7)
- Active Learning (Importance: 3.0/5 | Level: 3.12/7)
- Negotiation (Importance: 3.0/5 | Level: 3.0/7)
- Quality Control Analysis (Importance: 3.0/5 | Level: 3.12/7)
- Persuasion (Importance: 3.0/5 | Level: 3.12/7)
- Writing (Importance: 3.0/5 | Level: 3.12/7)
- Instructing (Importance: 3.0/5 | Level: 3.0/7)
- Service Orientation (Importance: 2.88/5 | Level: 3.0/7)
- Systems Evaluation (Importance: 2.88/5 | Level: 3.12/7)
- Systems Analysis (Importance: 2.88/5 | Level: 3.0/7)
- Equipment Selection (Importance: 2.88/5 | Level: 2.62/7)
- Operation and Control (Importance: 2.88/5 | Level: 3.0/7)
- Operations Monitoring (Importance: 2.88/5 | Level: 2.88/7)
- Mathematics (Importance: 2.75/5 | Level: 3.0/7)
- Operations Analysis (Importance: 2.5/5 | Level: 2.62/7)
- Management of Material Resources (Importance: 2.12/5 | Level: 2.25/7)
- Troubleshooting (Importance: 2.12/5 | Level: 2.0/7)
- Management of Financial Resources (Importance: 2.0/5 | Level: 2.0/7)
- Repairing (Importance: 2.0/5 | Level: 2.0/7)
- Equipment Maintenance (Importance: 2.0/5 | Level: 2.0/7)
- Science (Importance: 1.62/5 | Level: 0.75/7)
- Technology Design (Importance: 1.5/5 | Level: 0.75/7)
- Programming (Importance: 1.25/5 | Level: 0.25/7)
- Installation (Importance: 1.0/5 | Level: 0.0/7)

# TECHNOLOGY SKILLS & TOOLS
- Adobe Acrobat (Tech skill type: Document management software)
- Autodesk AutoCAD (Tech skill type: Computer aided design CAD software)
- Facilities management software (Tech skill type: Facilities management software)
- FranklinCovey TabletPlanner (Tech skill type: Calendar and scheduling software)
- Graphics software (Tech skill type: Graphics or photo imaging software)
- HCSS HeavyJob (Tech skill type: Project management software)
- Inventory tracking software (Tech skill type: Inventory management software)
- Mi-Co Mi-Forms (Tech skill type: Data base user interface and query software)
- Microsoft Excel (Tech skill type: Spreadsheet software)
- Microsoft NetMeeting (Tech skill type: Video conferencing software)
- Microsoft Office software (Tech skill type: Office suite software)
- Microsoft Outlook (Tech skill type: Electronic mail software)
- Microsoft PowerPoint (Tech skill type: Presentation software)
- Microsoft Project (Tech skill type: Project management software)
- Microsoft Word (Tech skill type: Word processing software)
- Oracle Primavera Enterprise Project Portfolio Management (Tech skill type: Project management software)
- Oracle Primavera P6 Enterprise Portfolio Project Management (Tech skill type: Project management software)
- Oracle Primavera Systems (Tech skill type: Project management software)
- Procore software (Tech skill type: Analytical or scientific software)
- Prolog (Tech skill type: Development environment software)
- QuickBase business management software (Tech skill type: Data base user interface and query software)
- Sage 300 Construction and Real Estate (Tech skill type: Data base user interface and query software)
- Scheduling software (Tech skill type: Calendar and scheduling software)
- Word processing software (Tech skill type: Word processing software)

## TOOLS USED
- Acetylene welding equipment (Tool type: Gas welding or brazing or cutting apparatus)
- Adjustable wrenches (Tool type: Adjustable wrenches)
- Aerial personnel lifts (Tool type: Manlift or personnel lift)
- Air compressors (Tool type: Air compressors)
- Allen wrenches (Tool type: Hex keys)
- Ammeters (Tool type: Ammeters)
- Analog temperature analyzers (Tool type: Surface thermometers)
- Arc welding equipment (Tool type: Shielded metal arc welding or stick welding machine)
- Backhoes (Tool type: Backhoes)
- Band saws (Tool type: Power saws)
- Bench vises (Tool type: Bench vises)
- Biscuit joiners (Tool type: Biscuit jointers)
- Blasting machines (Tool type: Detonator box)
- Brick trowels (Tool type: Trowels)
- Bubble levels (Tool type: Levels)
- Calipers (Tool type: Calipers)
- Caulking guns (Tool type: Caulking guns)
- Chalk lines (Tool type: Chalk lines)
- Channel lock pliers (Tool type: Locking pliers)
- Clamp-on meters (Tool type: Ammeters)
- Claw hammers (Tool type: Claw hammer)
- Combination squares (Tool type: Squares)
- Concrete floats (Tool type: Floats)
- Concrete mixers (Tool type: Concrete mixers or plants)
- Crowbars (Tool type: Pry bars)
- Desktop computers (Tool type: Desktop computers)
- Detonators (Tool type: Detonators)
- Digital cameras (Tool type: Digital cameras)
- Digital temperature analyzers (Tool type: Surface thermometers)
- Dump trucks (Tool type: Dump trucks)
- Fish tapes (Tool type: Fish tape)
- Flat head screwdrivers (Tool type: Screwdrivers)
- Flatbed truck trailers (Tool type: Flatbed trailers)
- Flow meters (Tool type: Flowmeters)
- Forklifts (Tool type: Forklifts)
- Fuel-burning kettles (Tool type: Kettle exchangers)
- Gas-powered generators (Tool type: Gas generators)
- Glass cutters (Tool type: Glass cutters)
- Glass gloves (Tool type: Protective gloves)
- Glass holders (Tool type: Hold down clamps)
- Glass lifters (Tool type: Lifts)
- Glass tongs (Tool type: Tongs)
- Hand saws (Tool type: Saws)
- Humidity meters (Tool type: Hygrometers)
- Hydraulic crimping tools (Tool type: Wire lug crimping tool)
- Hydraulic knock-out punches (Tool type: Stamping dies or punches)
- Insulated adjustable widemouth pliers (Tool type: Adjustable widemouth pliers)
- Insulated screwdrivers (Tool type: Insulated screwdriver)
- Ladders (Tool type: Ladders)
- Lathes (Tool type: Tracer or duplicating or contouring lathe)
- Layout squares (Tool type: Squares)
- Manlifts (Tool type: Manlift or personnel lift)
- Marking gauges (Tool type: Metal markers or holders)
- Measuring tapes (Tool type: Tape measures)
- Megohm meters (Tool type: Ohmmeters)
- Metal inert gas MIG welding equipment (Tool type: Metal inert gas welding machine)
- Mortar mixers (Tool type: Plaster or mortar mixers)
- Multimeters (Tool type: Multimeters)
- Nut drivers (Tool type: Nut drivers)
- Ohmmeters (Tool type: Ohmmeters)
- Oxyfuel gas welders (Tool type: Gas welding or brazing or cutting apparatus)
- Pallet jacks (Tool type: Pallet trucks)
- Personal computers (Tool type: Personal computers)
- Phillips head screwdrivers (Tool type: Screwdrivers)
- Pipe benders (Tool type: Pipe bending tools)
- Pipe cutters (Tool type: Pipe or tube cutter)
- Pipe threaders (Tool type: Threading die hand tool)
- Pipe vises (Tool type: Pipe vises)
- Pipe wrenches (Tool type: Pipe wrenches)
- Planers (Tool type: Planing machines)
- Planes (Tool type: Planes)
- Plumb bobs (Tool type: Plumb bobs)
- Pointing trowels (Tool type: Trowels)
- Power drills (Tool type: Power drills)
- Power grinders (Tool type: Power grinders)
- Power lockouts (Tool type: Lockout devices)
- Power nailers (Tool type: Power nail guns)
- Power polishers (Tool type: Power buffers)
- Power saws (Tool type: Power saws)
- Power washers (Tool type: Pressure or steam cleaners)
- Precision levels (Tool type: Levels)
- Pressure meters (Tool type: Pressure indicators)
- Protective ear muffs (Tool type: Acoustic ear muffs or defenders)
- Protective ear plugs (Tool type: Ear plugs)
- Pry bars (Tool type: Pry bars)
- Putty knives (Tool type: Putty knives)
- Refrigerant leak detectors (Tool type: Liquid leak detectors)
- Refrigerant reclamation equipment (Tool type: Refrigerant compressors)
- Respirators (Tool type: Respirators)
- Rubber mallets (Tool type: Rubber mallet)
- Saber saws (Tool type: Power saws)
- Safety glasses (Tool type: Safety glasses)
- Safety gloves (Tool type: Protective gloves)
- Safety goggles (Tool type: Goggles)
- Safety harnesses (Tool type: Safety harnesses or belts)
- Safety lanyards (Tool type: Fall protection lanyard)
- Scaffolding (Tool type: Scaffolding)
- Scoring tools (Tool type: Scribers)
- Screeds (Tool type: Concrete spreaders)
- Single-cut mill saw files (Tool type: Mill saw file)
- Skid steer loaders (Tool type: Skid steer loaders)
- Slickline fishing tools (Tool type: Wireline grabs)
- Steel chisels (Tool type: Cold chisels)
- Surveying rods (Tool type: Measuring rods)
- Swing stages (Tool type: Manlift or personnel lift)
- Table saws (Tool type: Power saws)
- Tablet computers (Tool type: Tablet computers)
- Theodolites (Tool type: Theodolites)
- Tracked excavators (Tool type: Track excavators)
- Transit levels (Tool type: Level sensors or transmitters)
- Trenchers (Tool type: Trenching machines)
- Tungsten inert gas TIG welding equipment (Tool type: Tungsten inert gas welding machine)
- Two way radios (Tool type: Two way radios)
- Utility knives (Tool type: Utility knives)
- Vacuum cups (Tool type: Suction cups)
- Vacuum pumps (Tool type: Vacuum pumps)
- Voltmeters (Tool type: Voltage or current meters)
- Wattmeters (Tool type: Wattmeters)
- Welders (Tool type: Spot welding machine)
- Welding masks (Tool type: Welding masks)
- Wheel loaders (Tool type: Wheel loaders)
- Wheeled bulldozers (Tool type: Wheel bulldozers)
- Wire crimpers (Tool type: Wire lug crimping tool)
- Wire cutters (Tool type: Wire cutters)
- Wire pulling machines (Tool type: Wire drawing machine)
- Wire strippers (Tool type: Stripping tools)
- Wood chisels (Tool type: Wood chisels)