Job Title: Food Scientists and Technologists
O*NET-SOC Code: 19-1012.00

# DESCRIPTION
Use chemistry, microbiology, engineering, and other sciences to study the principles underlying the processing and deterioration of foods; analyze food content to determine levels of vitamins, fat, sugar, and protein; discover new food sources; research ways to make processed foods safe, palatable, and healthful; and apply food science knowledge to determine best ways to process, package, preserve, store, and distribute food.

# TASKS
- Inspect food processing areas to ensure compliance with government regulations and standards for sanitation, safety, quality, and waste management.
- Check raw ingredients for maturity or stability for processing, and finished products for safety, quality, and nutritional value.
- Develop new or improved ways of preserving, processing, packaging, storing, and delivering foods, using knowledge of chemistry, microbiology, and other sciences.
- Test new products for flavor, texture, color, nutritional content, and adherence to government and industry standards.
- Stay up to date on new regulations and current events regarding food science by reviewing scientific literature.
- Evaluate food processing and storage operations and assist in the development of quality assurance programs for such operations.
- Confer with process engineers, plant operators, flavor experts, and packaging and marketing specialists to resolve problems in product development.
- Study the structure and composition of food or the changes foods undergo in storage and processing.
- Seek substitutes for harmful or undesirable additives, such as nitrites.
- Study methods to improve aspects of foods, such as chemical composition, flavor, color, texture, nutritional value, and convenience.
- Develop food standards and production specifications, safety and sanitary regulations, and waste management and water supply specifications.
- Develop new food items for production, based on consumer feedback.
- Demonstrate products to clients.

# SKILLS
(Scale definitions: Importance is rated 1-5. Level is rated 0-7.)
- Writing (Importance: 4.0/5 | Level: 4.0/7)
- Reading Comprehension (Importance: 4.0/5 | Level: 4.25/7)
- Active Listening (Importance: 4.0/5 | Level: 4.0/7)
- Complex Problem Solving (Importance: 3.88/5 | Level: 3.88/7)
- Speaking (Importance: 3.88/5 | Level: 4.0/7)
- Critical Thinking (Importance: 3.88/5 | Level: 4.25/7)
- Monitoring (Importance: 3.88/5 | Level: 3.88/7)
- Judgment and Decision Making (Importance: 3.75/5 | Level: 3.88/7)
- Active Learning (Importance: 3.75/5 | Level: 3.88/7)
- Science (Importance: 3.38/5 | Level: 3.38/7)
- Quality Control Analysis (Importance: 3.25/5 | Level: 3.75/7)
- Systems Evaluation (Importance: 3.25/5 | Level: 3.62/7)
- Systems Analysis (Importance: 3.25/5 | Level: 3.75/7)
- Mathematics (Importance: 3.12/5 | Level: 3.12/7)
- Social Perceptiveness (Importance: 3.12/5 | Level: 3.12/7)
- Persuasion (Importance: 3.0/5 | Level: 3.5/7)
- Time Management (Importance: 3.0/5 | Level: 3.75/7)
- Coordination (Importance: 3.0/5 | Level: 3.5/7)
- Service Orientation (Importance: 3.0/5 | Level: 3.12/7)
- Learning Strategies (Importance: 3.0/5 | Level: 3.0/7)
- Instructing (Importance: 3.0/5 | Level: 3.5/7)
- Negotiation (Importance: 3.0/5 | Level: 3.38/7)
- Operations Monitoring (Importance: 2.88/5 | Level: 3.0/7)
- Management of Personnel Resources (Importance: 2.75/5 | Level: 2.88/7)
- Operations Analysis (Importance: 2.25/5 | Level: 1.88/7)
- Troubleshooting (Importance: 2.12/5 | Level: 2.12/7)
- Operation and Control (Importance: 2.12/5 | Level: 2.0/7)
- Management of Material Resources (Importance: 2.0/5 | Level: 1.62/7)
- Management of Financial Resources (Importance: 2.0/5 | Level: 1.25/7)
- Technology Design (Importance: 1.88/5 | Level: 1.12/7)
- Programming (Importance: 1.62/5 | Level: 0.88/7)
- Equipment Selection (Importance: 1.62/5 | Level: 0.75/7)
- Equipment Maintenance (Importance: 1.0/5 | Level: 0.0/7)
- Repairing (Importance: 1.0/5 | Level: 0.0/7)
- Installation (Importance: 1.0/5 | Level: 0.0/7)

# TECHNOLOGY SKILLS & TOOLS
- BioDiscovery ImaGene (Tech skill type: Analytical or scientific software)
- HubSpot software (Tech skill type: Sales and marketing software)
- Hypertext markup language HTML (Tech skill type: Web platform development software)
- Image analysis software (Tech skill type: Analytical or scientific software)
- Insightful S-PLUS (Tech skill type: Analytical or scientific software)
- Marketo Marketing Automation (Tech skill type: Sales and marketing software)
- MDS Analytical Technologies GenePix Pro (Tech skill type: Analytical or scientific software)
- Microsoft Access (Tech skill type: Data base user interface and query software)
- Microsoft Excel (Tech skill type: Spreadsheet software)
- Microsoft Office software (Tech skill type: Office suite software)
- Microsoft Outlook (Tech skill type: Electronic mail software)
- Microsoft PowerPoint (Tech skill type: Presentation software)
- Microsoft Word (Tech skill type: Word processing software)
- Oracle Eloqua (Tech skill type: Customer relationship management CRM software)
- PathogenTracker (Tech skill type: Data base user interface and query software)
- R (Tech skill type: Object or component oriented development software)
- SAP software (Tech skill type: Enterprise resource planning ERP software)
- Sensory Computer Systems SIMS (Tech skill type: Analytical or scientific software)
- STATISTICA (Tech skill type: Analytical or scientific software)
- Structured query language SQL (Tech skill type: Data base user interface and query software)
- Tableau (Tech skill type: Business intelligence and data analysis software)
- U.S. Department of Agriculture USDA National Nutrient Database (Tech skill type: Data base user interface and query software)
- Word processing software (Tech skill type: Word processing software)

## TOOLS USED
- Air sampling systems (Tool type: Air samplers or collectors)
- Amino acid analyzers (Tool type: Amino acid analyzers)
- Amylographs (Tool type: Viscosimeters)
- Anaerobic growth chambers (Tool type: Anaerobic chamber)
- Analytical balances (Tool type: Analytical balances)
- Atomic absorption AA spectrometers (Tool type: Atomic absorption AA spectrometers)
- Automatic diluters (Tool type: Laboratory diluters)
- Autosamplers (Tool type: Autosamplers)
- Bacterial identification systems (Tool type: Microbiology analyzers)
- Batch fryers (Tool type: Commercial use deep fryers)
- Benchtop nephelometers (Tool type: Nephelometers)
- Biological safety cabinets (Tool type: Sterilization cabinets)
- Bioreactors (Tool type: Tissue culture incubators)
- Blast freezers (Tool type: Blast freezers)
- Carbon dioxide CO2 laboratory incubators (Tool type: Dry wall single chamber carbon dioxide incubators)
- Color difference meters (Tool type: Color sensors)
- Colorimeters (Tool type: Colorimeters)
- Commercial microwave ovens (Tool type: Commercial use microwave ovens)
- Computerized calorimeters (Tool type: Calorimeters)
- Conductivity meters (Tool type: Conductivity meters)
- Coulter counters (Tool type: Manual or electronic hematology differential cell counters)
- Darkfield microscopes (Tool type: Darkfield microscopes)
- Dehydration equipment (Tool type: Dehydrators)
- Dejuicers (Tool type: Juicing machinery)
- Desktop computers (Tool type: Desktop computers)
- Differential refractometers (Tool type: Bench refractometers or polarimeters)
- Digital oscilloscopes (Tool type: Oscilloscopes)
- Drum dryers (Tool type: Dehydrating machinery)
- Dynamic light scattering equipment (Tool type: Light scattering equipment)
- Dynamic mechanical analyzers DMA (Tool type: Thermal differential analyzers)
- Electronic laboratory balances (Tool type: Laboratory balances)
- Emulsifiers (Tool type: Laboratory blenders or emulsifiers)
- Epifluorescence microscopes (Tool type: Fluorescent microscopes)
- Extractors (Tool type: Extracting equipment for laboratories)
- Fermenting tanks (Tool type: Standard fermentation units)
- Food choppers (Tool type: Commercial use food choppers or cubers or dicers)
- Food crushers (Tool type: Crushing machinery)
- Food dehydrators (Tool type: Dehydrating machinery)
- Food mixers (Tool type: Commercial use mixers)
- Food slicers (Tool type: Commercial use food slicers)
- Fourier transform infrared FTIR spectrometers (Tool type: Infrared spectrometers)
- Fraction collectors (Tool type: Electrophoresis system accessories)
- Freeze drying equipment (Tool type: Freeze dryers or lyopholizers)
- Fruit presses (Tool type: Crushing machinery)
- Gas chromatographs GC (Tool type: Gas chromatographs)
- Gel electrophoresis equipment (Tool type: Gel documentation systems)
- Glucose analyzers (Tool type: Sugar analyzers)
- Griddles (Tool type: Commercial use griddles)
- Grills (Tool type: Commercial use grills)
- Heat exchangers (Tool type: Laboratory heat exchange condensers)
- High pressure liquid chromatograph HPLC equipment (Tool type: High pressure liquid chromatograph chromatography)
- High speed refrigerated centrifuges (Tool type: Refrigerated benchtop centrifuges)
- Homogenizers (Tool type: Homogenizers)
- Ice cream freezers (Tool type: Ice cream machines)
- Induction cooktops (Tool type: Commercial use ranges)
- Infrared IR spectrometers (Tool type: Infrared spectrometers)
- Ion chromatographs (Tool type: Ion chromatographs)
- Jet cooking systems (Tool type: Cooking machinery)
- Laboratory lasers (Tool type: Lasers)
- Laboratory mechanical convection ovens (Tool type: Laboratory mechanical convection ovens)
- Laboratory mills (Tool type: Laboratory mills)
- Laboratory ovens (Tool type: Laboratory mechanical convection ovens)
- Laboratory water baths (Tool type: Water baths)
- Laptop computers (Tool type: Notebook computers)
- Laser colony counters (Tool type: Electronic counters)
- Macro kjeldahls (Tool type: Kjeldahl nitrogen determination apparatus)
- Mass spectrometers (Tool type: Mass spectrometers)
- Meat grinders (Tool type: Commercial use food grinders)
- Meat saws (Tool type: Cutting machinery)
- Melting point apparatus (Tool type: Melting point recorders)
- Membrane filtration systems (Tool type: Laboratory membrane filters)
- Micro kjeldahls (Tool type: Kjeldahl nitrogen determination apparatus)
- Microbial monitoring systems (Tool type: Microbiological aircontrol equipment)
- Microcentrifuges (Tool type: Microcentrifuges)
- Muffle furnaces (Tool type: Laboratory box furnaces)
- Nitrogen analyzers (Tool type: Nitrogen or nitrate or nitrite analyzer)
- Orbital shaking water baths (Tool type: Orbital shaking water baths)
- Oxygen analyzers (Tool type: Oxygen gas analyzers)
- Personal computers (Tool type: Personal computers)
- pH indicators (Tool type: pH meters)
- Phase contrast microscopes (Tool type: Darkfield microscopes)
- Piston filling machines (Tool type: Filling machinery)
- Plate heat exchangers (Tool type: Laboratory heat exchange condensers)
- Programmable incubators (Tool type: Forced air or mechanical convection general purpose incubators)
- Pulper finishers (Tool type: Crushing machinery)
- Pulsifiers (Tool type: Laboratory blenders or emulsifiers)
- Ranges (Tool type: Commercial use ranges)
- Reflectance spectrometers (Tool type: Spectrometers)
- Refrigerated benchtop centrifuges (Tool type: Refrigerated benchtop centrifuges)
- Retort sterilization equipment (Tool type: Flask or retort units)
- Rheometers (Tool type: Rheometers)
- Roasting equipment (Tool type: Roasting machinery)
- Rotary evaporators (Tool type: Vacuum or rotary evaporators)
- Scanning electron microscopes SEM (Tool type: Scanning electron microscopes)
- Scanning plate readers (Tool type: Microplate readers)
- Specific gravity fat analyzers (Tool type: Fat extractors)
- Spectrofluorimeters (Tool type: Spectrofluorimeters or fluorimeters)
- Spiral platers (Tool type: Microbiology analyzers)
- Steam autoclaves (Tool type: Steam autoclaves or sterilizers)
- Steam blanchers (Tool type: Blanching machinery)
- Steam kettles (Tool type: Commercial use steamers)
- Stomachers (Tool type: Stomachers)
- Strain testers (Tool type: Strain gauges)
- Stuffers (Tool type: Filling machinery)
- Thermal cyclers (Tool type: Temperature cycling chambers or thermal cyclers)
- Thermal gravimetric analyzers (Tool type: Thermo gravimetry analyzers)
- Thermal processing equipment (Tool type: Cooking machinery)
- Torsion gelometers (Tool type: Solution strength estimation apparatus)
- Tubular heat exchangers (Tool type: Laboratory heat exchange condensers)
- Ultraviolet UV spectrometers (Tool type: Spectrofluorimeters or fluorimeters)
- Vacuum packagers (Tool type: Packaging vacuum)
- Viscometers (Tool type: Viscosimeters)
- Water activity meters (Tool type: Water analysis systems)
- X ray crystallography equipment (Tool type: X ray diffraction equipment)