Job Title: Health Specialties Teachers, Postsecondary
O*NET-SOC Code: 25-1071.00

# DESCRIPTION
Teach courses in health specialties, in fields such as dentistry, laboratory technology, medicine, pharmacy, public health, therapy, and veterinary medicine.

# TASKS
- Prepare course materials, such as syllabi, homework assignments, and handouts.
- Keep abreast of developments in the field by reading current literature, talking with colleagues, and participating in professional conferences.
- Evaluate and grade students' class work, assignments, and papers.
- Supervise laboratory sessions.
- Compile, administer, and grade examinations, or assign this work to others.
- Maintain student attendance records, grades, and other required records.
- Initiate, facilitate, and moderate classroom discussions.
- Plan, evaluate, and revise curricula, course content, course materials, and methods of instruction.
- Supervise undergraduate or graduate teaching, internship, and research work.
- Participate in student recruitment, registration, and placement activities.
- Select and obtain materials and supplies, such as textbooks and laboratory equipment.
- Collaborate with colleagues to address teaching and research issues.
- Serve on academic or administrative committees that deal with institutional policies, departmental matters, and academic issues.
- Advise students on academic and vocational curricula and on career issues.
- Maintain regularly scheduled office hours to advise and assist students.
- Conduct research in a particular field of knowledge and publish findings in professional journals, books, or electronic media.
- Participate in campus and community events.
- Prepare and deliver lectures to undergraduate or graduate students on topics such as public health, stress management, and work site health promotion.
- Perform administrative duties, such as serving as department head.
- Write grant proposals to procure external research funding.
- Act as advisers to student organizations.
- Compile bibliographies of specialized materials for outside reading assignments.

# SKILLS
(Scale definitions: Importance is rated 1-5. Level is rated 0-7.)
- Instructing (Importance: 4.12/5 | Level: 4.38/7)
- Speaking (Importance: 4.12/5 | Level: 4.88/7)
- Reading Comprehension (Importance: 4.12/5 | Level: 5.0/7)
- Active Learning (Importance: 4.0/5 | Level: 4.0/7)
- Active Listening (Importance: 4.0/5 | Level: 4.62/7)
- Learning Strategies (Importance: 4.0/5 | Level: 4.12/7)
- Writing (Importance: 4.0/5 | Level: 5.0/7)
- Critical Thinking (Importance: 4.0/5 | Level: 4.12/7)
- Judgment and Decision Making (Importance: 3.88/5 | Level: 3.88/7)
- Complex Problem Solving (Importance: 3.75/5 | Level: 4.0/7)
- Time Management (Importance: 3.75/5 | Level: 3.88/7)
- Monitoring (Importance: 3.62/5 | Level: 3.88/7)
- Social Perceptiveness (Importance: 3.25/5 | Level: 3.62/7)
- Science (Importance: 3.25/5 | Level: 3.5/7)
- Coordination (Importance: 3.12/5 | Level: 3.5/7)
- Persuasion (Importance: 3.0/5 | Level: 3.12/7)
- Service Orientation (Importance: 3.0/5 | Level: 3.0/7)
- Negotiation (Importance: 3.0/5 | Level: 3.0/7)
- Mathematics (Importance: 3.0/5 | Level: 3.0/7)
- Management of Personnel Resources (Importance: 2.88/5 | Level: 2.88/7)
- Systems Analysis (Importance: 2.88/5 | Level: 2.88/7)
- Systems Evaluation (Importance: 2.88/5 | Level: 2.88/7)
- Operations Analysis (Importance: 2.38/5 | Level: 2.75/7)
- Quality Control Analysis (Importance: 2.0/5 | Level: 1.38/7)
- Management of Material Resources (Importance: 1.88/5 | Level: 1.25/7)
- Management of Financial Resources (Importance: 1.88/5 | Level: 1.12/7)
- Operations Monitoring (Importance: 1.88/5 | Level: 1.38/7)
- Operation and Control (Importance: 1.62/5 | Level: 0.62/7)
- Repairing (Importance: 1.62/5 | Level: 0.75/7)
- Equipment Selection (Importance: 1.62/5 | Level: 0.62/7)
- Equipment Maintenance (Importance: 1.62/5 | Level: 0.75/7)
- Troubleshooting (Importance: 1.62/5 | Level: 0.75/7)
- Programming (Importance: 1.38/5 | Level: 0.5/7)
- Technology Design (Importance: 1.38/5 | Level: 0.5/7)
- Installation (Importance: 1.0/5 | Level: 0.0/7)

# TECHNOLOGY SKILLS & TOOLS
- Adobe Presenter (Tech skill type: Computer based training software)
- Articulate Rapid E-Learning Studio (Tech skill type: Computer based training software)
- Blackboard Learn (Tech skill type: Computer based training software)
- Blackboard software (Tech skill type: Data base user interface and query software)
- Calendar and scheduling software (Tech skill type: Calendar and scheduling software)
- Collaborative editing software (Tech skill type: Word processing software)
- Course management system software (Tech skill type: Computer based training software)
- Dental software (Tech skill type: Medical software)
- Desire2Learn LMS software (Tech skill type: Computer based training software)
- DOC Cop (Tech skill type: Information retrieval or search software)
- EcoLogic ADAM Indoor Air Quality and Analytical Data Management (Tech skill type: Data base user interface and query software)
- Electronic health record EHR software (Tech skill type: Medical software)
- Email software (Tech skill type: Electronic mail software)
- Geographic information system GIS software (Tech skill type: Geographic information system)
- Google Docs (Tech skill type: Word processing software)
- Healthcare common procedure coding system HCPCS (Tech skill type: Medical software)
- IBM SPSS Statistics (Tech skill type: Analytical or scientific software)
- Image scanning software (Tech skill type: Optical character reader OCR or scanning software)
- InteractElsevier Netter's 3D Interactive Anatomy (Tech skill type: Medical software)
- iParadigms Turnitin (Tech skill type: Information retrieval or search software)
- Learning management system LMS (Tech skill type: Computer based training software)
- Material safety data sheet MSDS software (Tech skill type: Compliance software)
- Medical condition coding software (Tech skill type: Medical software)
- Medical procedure coding software (Tech skill type: Medical software)
- Microsoft Access (Tech skill type: Data base user interface and query software)
- Microsoft Excel (Tech skill type: Spreadsheet software)
- Microsoft Office software (Tech skill type: Office suite software)
- Microsoft Outlook (Tech skill type: Electronic mail software)
- Microsoft PowerPoint (Tech skill type: Presentation software)
- Microsoft Word (Tech skill type: Word processing software)
- Sakai CLE (Tech skill type: Computer based training software)
- SAS (Tech skill type: Analytical or scientific software)
- TechSmith Snagit (Tech skill type: Graphics or photo imaging software)
- Turning Technologies TurningPoint (Tech skill type: Multi-media educational software)
- Web browser software (Tech skill type: Internet browser software)

## TOOLS USED
- 3D movement analysis systems (Tool type: Motion analysis system)
- Agar slides (Tool type: Microscope slides)
- Automated ESR analyzers (Tool type: Hematology analyzers)
- Back support braces (Tool type: Back or lumbar or sacral orthopedic softgoods)
- Balance boards (Tool type: Balance beams or boards or bolsters or rockers for rehabilitation or therapy)
- Biohazard containers (Tool type: Needle or blade or sharps disposal containers or carts)
- Blood culture incubators (Tool type: Shaking incubators)
- Cardiac monitors (Tool type: Cardiac output CO monitoring units)
- Carousel slide projectors (Tool type: Slide projectors)
- Casting ovens (Tool type: Laboratory mechanical convection ovens)
- Cell washing equipment (Tool type: Blood bank cell washers)
- Cervical traction units (Tool type: Pelvis or back traction supplies)
- Coagulation testing equipment (Tool type: Coagulation analyzers)
- Colorimetric devices (Tool type: Colorimeters)
- Compact digital cameras (Tool type: Digital cameras)
- Compact disk CD players (Tool type: Compact disk players or recorders)
- Computer data input scanners (Tool type: Scanners)
- Computer laser printers (Tool type: Laser printers)
- Computer projectors (Tool type: Multimedia projectors)
- Conference telephones (Tool type: Teleconference equipment)
- Crash carts (Tool type: Emergency or resuscitation carts)
- Crutches (Tool type: Crutches)
- Curing lights (Tool type: Cosmetic dentistry curing lights)
- Dental air water syringes (Tool type: Teeth cleaning devices)
- Dental amalgamation equipment (Tool type: Dental amalgamators)
- Dental handpieces (Tool type: Dental handpieces)
- Dental laboratory lathes (Tool type: Dental laboratory lathes)
- Dental laboratory model trimmers (Tool type: Dental laboratory model trimmers)
- Dental laser equipment (Tool type: Dental lasers)
- Dental patient chairs (Tool type: Dental examination chairs)
- Dental suction units (Tool type: Dental saliva ejectors or oral suction devices)
- Desktop computers (Tool type: Desktop computers)
- Digital calculators (Tool type: Scientific calculator)
- Digital imaging workstations (Tool type: Desktop computers)
- Digital medical thermometers (Tool type: Electronic medical thermometers)
- Digital refractometers (Tool type: Bench refractometers or polarimeters)
- Digital video cameras (Tool type: Digital camcorders or video cameras)
- Digital video disk DVD players (Tool type: Digital video disk players or recorders)
- Diode lasers (Tool type: Lasers)
- Electric stimulation machines (Tool type: Electrotherapy combination units)
- Electrocardiography EKG machines (Tool type: Electrocardiography EKG units)
- Electromyography EMG systems (Tool type: Electromyography EMG units)
- Electrosurgery devices (Tool type: Electrosurgical or electrocautery equipment)
- Emergency eyewash stations (Tool type: Eyewashers or eye wash stations)
- Emergency first aid kits (Tool type: Mobile medical services first aid kits)
- Equipment dollies (Tool type: Dollies)
- Ergometers (Tool type: Ergometer)
- Exercise trampolines (Tool type: Exercise trampolines)
- Flat panel c-arms (Tool type: Medical c arm x ray units)
- Flow hoods (Tool type: Laminar flow cabinets or stations)
- Force measurement plates (Tool type: Pressure indicators)
- Free weights (Tool type: Fitness weights)
- Fume hoods (Tool type: Fume hoods or cupboards)
- Functional electrical stimulation FES equipment (Tool type: Neuromuscular stimulators or kits)
- Gait analysis equipment (Tool type: Gait analysis apparatus)
- Gait belts (Tool type: Gait belts for rehabilitation or therapy)
- General purpose laboratory test tubes (Tool type: Multipurpose or general test tubes)
- Goniometers or arthrometers (Tool type: Goniometers or arthrometers)
- Graduated glass cylinders (Tool type: Laboratory graduated cylinders)
- Hand grips (Tool type: Wrist exercisers for rehabilitation or therapy)
- Handheld microphones (Tool type: Microphones)
- Hemacytometers (Tool type: Hemacytometer sets)
- Hematology test kits (Tool type: Hematology test kits or supplies)
- High-lo manipulation tables (Tool type: Mats or platforms for rehabilitation or therapy)
- High-voltage galvanic stimulation machines (Tool type: Galvanic or faradic stimulators)
- Hospital beds (Tool type: Patient care beds for general use)
- Hoyer lifts (Tool type: Patient lifts)
- Hypodermic syringes (Tool type: Medical syringes with needle)
- Immuno-chemistry analyzers (Tool type: Immunology analyzers)
- Interactive whiteboard controllers (Tool type: Portable data input terminals)
- Interactive whiteboards (Tool type: Touch screen monitors)
- Intraoperative ultrasound monitors (Tool type: Medical ultrasound or doppler or echocardiograph monitors)
- Intraoral cameras (Tool type: Digital cameras)
- Isokinetic lower body testing machines (Tool type: Lower body resistance machines)
- Isokinetic upper body testing machines (Tool type: Upper body resistance machines)
- Knee support braces (Tool type: Knee therapeutic brace or support)
- Laboratory balances (Tool type: Laboratory balances)
- Laboratory heating blocks (Tool type: Dry baths or heating blocks)
- Laboratory osmometers (Tool type: Osmometers)
- Laboratory vortex mixers (Tool type: Vortex mixers)
- Laboratory water baths (Tool type: Water baths)
- Laptop computers (Tool type: Notebook computers)
- Large animal gamma cameras (Tool type: Medical gamma cameras for general use)
- Large bore computed tomography CT scanners (Tool type: Medical computed tomography CT or CAT scanners or tubes)
- Large bore positron emission tomography PET scanners (Tool type: Medical positron emission tomography PET units)
- Laser facsimile machines (Tool type: Laser fax machine)
- Laser scanning confocal microscopes (Tool type: Scanning light or spinning disk or laser scanning microscopes)
- Lead aprons (Tool type: Medical radiological shielding aprons or masks or drapes)
- Liquid crystal display LCD projectors (Tool type: Liquid crystal display projector)
- Liquid crystal display LCD televisions (Tool type: Televisions)
- Lumbar corsets (Tool type: Back or lumbar or sacral orthopedic softgoods)
- Mechanical stethoscopes (Tool type: Medical acoustic stethoscopes)
- Medical linear accelerators (Tool type: Mobile or transportable medical linear accelerators)
- Medical measuring tapes (Tool type: Medical tape measures)
- Medical picture archiving computer systems PACS (Tool type: Medical picture archiving computer systems PACS)
- Medicine balls (Tool type: Medicine ball)
- Micro-etchers (Tool type: Electro etcher marking machine)
- Microcryostats (Tool type: Cryostats)
- Microdissection systems (Tool type: Postmortem animal dissection tables)
- Microhematocrit centrifuges (Tool type: Microcentrifuges)
- Microphone podiums (Tool type: Microphone stand)
- Microplate readers (Tool type: Microplate readers)
- MP3 digital voice recorders (Tool type: MP3 players or recorders)
- Multi-line telephone systems (Tool type: Special purpose telephones)
- Multimedia projection equipment (Tool type: Multimedia projectors)
- Opaque projectors (Tool type: Epidiascopes)
- Oral evacuation systems (Tool type: Dental saliva ejectors or oral suction devices)
- Overhead data projectors (Tool type: Overhead projectors)
- Oxygen tanks (Tool type: Medical gas cylinders or related devices)
- Pan-tilt-zoom PTZ cameras (Tool type: Digital cameras)
- Panoramic x ray machines (Tool type: Dental x ray units)
- Parallel bars (Tool type: Parallel bars for rehabilitation or therapy)
- Patient wheelchairs (Tool type: Wheelchairs)
- Pelvic traction equipment (Tool type: Pelvis or back traction supplies)
- Petri dishes (Tool type: Petri plates or dishes)
- Photocopying equipment (Tool type: Photocopiers)
- Pipetting devices (Tool type: Dropping pipettes)
- Polyether mixing machines (Tool type: Laboratory mixers)
- Poster printers (Tool type: Inkjet printers)
- Posture scale analyzers (Tool type: Posture evaluation kit)
- Powder boards (Tool type: Powder boards for rehabilitation or therapy)
- Pressure steam autoclaves (Tool type: Steam autoclaves or sterilizers)
- Projector screens (Tool type: Projection screens or displays)
- Protective medical face masks (Tool type: Surgical isolation or surgical masks)
- Protective medical gloves (Tool type: Medical exam or non surgical procedure gloves)
- Pulse oximeters (Tool type: Pulse oximeter units)
- Reachers (Tool type: Reachers for the physically challenged)
- Recumbent exercise bicycles (Tool type: Stationary bicycles)
- Reflex hammers (Tool type: Reflex hammers or mallets)
- Remote webcams (Tool type: Web cameras)
- Resistive exercise bands (Tool type: Resistive exercise bands or putty or tubing for rehabilitation or therapy)
- Rotating bed (Tool type: Patient care beds for general use)
- Rotator mixers (Tool type: Laboratory mixers)
- Sequential pump equipment (Tool type: Therapeutic cryo compression therapy systems)
- Slide stainers (Tool type: Histology or cytology slide stainers)
- Sliding boards (Tool type: Patient shifting boards)
- Sphygmomanometers (Tool type: Blood pressure cuff kits)
- Spill cleanup kits (Tool type: Spill kits)
- Stationary exercise bicycles (Tool type: Stationary bicycles)
- Step monitoring devices (Tool type: Physiological recorders)
- Student response systems (Tool type: Portable data input terminals)
- Tablet computers (Tool type: Tablet computers)
- Television monitors (Tool type: Televisions)
- Therapeutic cold packs (Tool type: Therapeutic heating or cooling pads or compresses or packs)
- Therapeutic hot packs (Tool type: Therapeutic heating or cooling pads or compresses or packs)
- Therapeutic treadmill exercisers (Tool type: Treadmill exercisers for rehabilitation or therapy)
- Therapeutic whirlpool baths (Tool type: Full body immersion hydrotherapy baths or tanks)
- Tilt tables (Tool type: Patient care beds for specialty care)
- Tooth shade guides (Tool type: Dental shades)
- Total lift chairs (Tool type: Patient lifts)
- Total parenteral nutrition TPN compounders (Tool type: Laboratory blenders or emulsifiers)
- Transcutaneous electric nerve stimulation TENS equipment (Tool type: Transcutaneous electric nerve stimulation units)
- Transmission electron microscopes TEM (Tool type: Transmission electron microscopes)
- Ultrasonic scalers (Tool type: Dental scalers)
- Ultrasonic sterilization units (Tool type: Ultrasonic cleaning equipment)
- Ultrasound machines (Tool type: Ultrasonic therapy apparatus or supplies)
- Universal serial bus USB flash drives (Tool type: High capacity removable media drives)
- Upper extremity slings (Tool type: Arm orthopedic softgoods)
- Urine analyzers (Tool type: Urinalysis analyzers)
- Vacuum formers (Tool type: Dental formers)
- Video endoscopy equipment (Tool type: Endoscopic video cameras or recorders or adapters or accessories)
- Video recording systems (Tool type: Digital camcorders or video cameras)
- Videoconferencing equipment (Tool type: Videoconferencing systems)
- Virtual reality augmented cycling kits VRACK (Tool type: Head mounted displays)
- Walkers (Tool type: Walkers or rollators)
- Walking canes (Tool type: Canes)
- Web-based telerehabilitation monitoring systems (Tool type: Physiological recorders)
- Webcams (Tool type: Web cameras)
- Wireless microphones (Tool type: Microphones)
- Wrist splints (Tool type: Orthopedic splint systems)