Job Title: Industrial Machinery Mechanics
O*NET-SOC Code: 49-9041.00

# DESCRIPTION
Repair, install, adjust, or maintain industrial production and processing machinery or refinery and pipeline distribution systems. May also install, dismantle, or move machinery and heavy equipment according to plans.

# TASKS
- Repair or maintain the operating condition of industrial production or processing machinery or equipment.
- Repair or replace broken or malfunctioning components of machinery or equipment.
- Clean, lubricate, or adjust parts, equipment, or machinery.
- Disassemble machinery or equipment to remove parts and make repairs.
- Reassemble equipment after completion of inspections, testing, or repairs.
- Examine parts for defects, such as breakage or excessive wear.
- Record repairs and maintenance performed.
- Operate newly repaired machinery or equipment to verify the adequacy of repairs.
- Record parts or materials used and order or requisition new parts or materials, as necessary.
- Observe and test the operation of machinery or equipment to diagnose malfunctions, using voltmeters or other testing devices.
- Analyze test results, machine error messages, or information obtained from operators to diagnose equipment problems.
- Study blueprints or manufacturers' manuals to determine correct installation or operation of machinery.
- Cut and weld metal to repair broken metal parts, fabricate new parts, or assemble new equipment.
- Enter codes and instructions to program computer-controlled machinery.
- Demonstrate equipment functions and features to machine operators.
- Assign schedules to work crews.

# SKILLS
(Scale definitions: Importance is rated 1-5. Level is rated 0-7.)
- Operation and Control (Importance: 4.0/5 | Level: 4.0/7)
- Troubleshooting (Importance: 4.0/5 | Level: 4.0/7)
- Repairing (Importance: 4.0/5 | Level: 4.0/7)
- Equipment Maintenance (Importance: 4.0/5 | Level: 4.12/7)
- Operations Monitoring (Importance: 4.0/5 | Level: 4.0/7)
- Quality Control Analysis (Importance: 3.75/5 | Level: 3.75/7)
- Critical Thinking (Importance: 3.62/5 | Level: 3.5/7)
- Monitoring (Importance: 3.12/5 | Level: 3.12/7)
- Active Listening (Importance: 3.12/5 | Level: 3.0/7)
- Active Learning (Importance: 3.12/5 | Level: 3.12/7)
- Equipment Selection (Importance: 3.12/5 | Level: 3.12/7)
- Complex Problem Solving (Importance: 3.12/5 | Level: 3.0/7)
- Judgment and Decision Making (Importance: 3.12/5 | Level: 3.0/7)
- Time Management (Importance: 3.0/5 | Level: 3.0/7)
- Speaking (Importance: 3.0/5 | Level: 3.0/7)
- Coordination (Importance: 3.0/5 | Level: 3.0/7)
- Reading Comprehension (Importance: 2.88/5 | Level: 3.0/7)
- Systems Evaluation (Importance: 2.88/5 | Level: 2.88/7)
- Systems Analysis (Importance: 2.88/5 | Level: 2.88/7)
- Social Perceptiveness (Importance: 2.75/5 | Level: 2.12/7)
- Writing (Importance: 2.75/5 | Level: 2.75/7)
- Installation (Importance: 2.62/5 | Level: 3.0/7)
- Instructing (Importance: 2.62/5 | Level: 2.75/7)
- Management of Personnel Resources (Importance: 2.62/5 | Level: 2.12/7)
- Learning Strategies (Importance: 2.62/5 | Level: 2.88/7)
- Mathematics (Importance: 2.38/5 | Level: 2.5/7)
- Service Orientation (Importance: 2.25/5 | Level: 2.25/7)
- Persuasion (Importance: 2.12/5 | Level: 1.75/7)
- Technology Design (Importance: 2.0/5 | Level: 1.88/7)
- Operations Analysis (Importance: 1.88/5 | Level: 1.75/7)
- Negotiation (Importance: 1.88/5 | Level: 1.75/7)
- Programming (Importance: 1.75/5 | Level: 1.5/7)
- Science (Importance: 1.75/5 | Level: 1.5/7)
- Management of Material Resources (Importance: 1.75/5 | Level: 0.88/7)
- Management of Financial Resources (Importance: 1.62/5 | Level: 0.88/7)

# TECHNOLOGY SKILLS & TOOLS
- BIT Corp ProMACS PLC (Tech skill type: Industrial control software)
- Computer aided design CAD software (Tech skill type: Computer aided design CAD software)
- Extranet Machine Tools Suite (Tech skill type: Computer aided manufacturing CAM software)
- Inventory tracking software (Tech skill type: Inventory management software)
- KEYENCE PLC Ladder Logic (Tech skill type: Industrial control software)
- Maintenance management software (Tech skill type: Facilities management software)
- Maintenance planning and control software (Tech skill type: Data base user interface and query software)
- Microsoft Excel (Tech skill type: Spreadsheet software)
- Microsoft Office software (Tech skill type: Office suite software)
- Microsoft Outlook (Tech skill type: Electronic mail software)
- Microsoft PowerPoint (Tech skill type: Presentation software)
- Microsoft Word (Tech skill type: Word processing software)
- Programmable logic controller PLC software (Tech skill type: Industrial control software)
- SAP software (Tech skill type: Enterprise resource planning ERP software)
- Supervisory control and data acquisition SCADA software (Tech skill type: Industrial control software)
- Web browser software (Tech skill type: Internet browser software)

## TOOLS USED
- Acetylene torches (Tool type: Blow torch)
- Adjustable widemouth pliers (Tool type: Adjustable widemouth pliers)
- Adjustable wrenches (Tool type: Adjustable wrenches)
- Air compressors (Tool type: Air compressors)
- Airhammer chisels (Tool type: Cold chisels)
- Airpowered descaling drills (Tool type: Pneumatic drill)
- Airpowered descaling turbines (Tool type: Pneumatic sanding machines)
- Alignment scopes (Tool type: Magnifiers)
- Alignment tools (Tool type: Alignment jig)
- Allen wrenches (Tool type: Hex keys)
- Ammeters (Tool type: Ammeters)
- Angled feeler gauges (Tool type: Feeler gauges)
- Aviation snips (Tool type: Metal cutters)
- Bandsaws (Tool type: Metal band sawing machine)
- Bearing bridge gauges (Tool type: Strain gauges)
- Bearing heating ovens (Tool type: Induction heaters)
- Block and tackle equipment (Tool type: Blocks or pulleys)
- Boring tools (Tool type: Boring machines)
- Brass hammers (Tool type: Hammers)
- Brazing equipment (Tool type: Welder torch)
- Broaching machines (Tool type: Metal broaching machines)
- Burnishing wheels (Tool type: Burnishing machine)
- Calipers (Tool type: Calipers)
- Chain falls (Tool type: Hoists)
- Chain hoists (Tool type: Hoists)
- Channel lock pliers (Tool type: Locking pliers)
- Combination wrenches (Tool type: Combination wrenches)
- Cutting dies (Tool type: Cutting die)
- Cutting machines (Tool type: Cutting machines)
- Cylindrical grinders (Tool type: Power grinders)
- Cylindrical procedures squares (Tool type: Squares)
- Desktop computers (Tool type: Desktop computers)
- Dial calipers (Tool type: Calipers)
- Drill presses (Tool type: Drill press or radial drill)
- Electric rotary wire brushes (Tool type: Wire brushes)
- Emery wheels (Tool type: Tungsten carbide abrasive wheels)
- Engine lathes (Tool type: Horizontal turning center)
- Equipment rollers (Tool type: Dollies)
- Facing machines (Tool type: Tube end finisher)
- Feeler gauges (Tool type: Feeler gauges)
- Flange facing machines (Tool type: Pipe or tube cutter)
- Flat files (Tool type: Flat hand file)
- Flow meters (Tool type: Flowmeters)
- Forklifts (Tool type: Forklifts)
- Gas welding equipment (Tool type: Gas welding or brazing or cutting apparatus)
- Gauges (Tool type: Height gauges)
- Grease guns (Tool type: Grease guns)
- Grinding wheels (Tool type: Power grinders)
- Half-round files (Tool type: Half round file)
- Hammers (Tool type: Hammers)
- Hand pumps (Tool type: Hand pumps)
- Handsaws (Tool type: Saws)
- Hex wrenches (Tool type: Hex keys)
- Hoists (Tool type: Hoists)
- Hydraulic pullers (Tool type: Pullers)
- Hydraulic squeezers (Tool type: Hydraulic press brake)
- Hydrostatic testers (Tool type: Pressure indicators)
- Impact wrenches (Tool type: Impact wrenches)
- Inside micrometers (Tool type: Micrometers)
- Jacks (Tool type: Jacks)
- Jigs (Tool type: Positioning jig)
- Ladders (Tool type: Ladders)
- Lapping wheels (Tool type: Grinders)
- Laser measuring equipment (Tool type: Laser measuring systems)
- Laser printers (Tool type: Laser printers)
- Lathes (Tool type: Tracer or duplicating or contouring lathe)
- Level gauges (Tool type: Levels)
- Levels (Tool type: Levels)
- Magnetic retrievers (Tool type: Magnetic tools)
- Metal cutting taps (Tool type: Taps)
- Metal inert gas MIG welders (Tool type: Metal inert gas welding machine)
- Micrometers (Tool type: Micrometers)
- Milling machines (Tool type: Milling machines)
- Multimeters (Tool type: Multimeters)
- Needlenose pliers (Tool type: Needlenose pliers)
- Optical measuring equipment (Tool type: Profile projectors)
- Oscilloscopes (Tool type: Oscilloscopes)
- Outside micrometers (Tool type: Micrometers)
- Personal computers (Tool type: Personal computers)
- Phillips head screwdrivers (Tool type: Screwdrivers)
- Pinchbars (Tool type: Pry bars)
- Pipe threaders (Tool type: Threading die hand tool)
- Pipe wrenches (Tool type: Pipe wrenches)
- Plasma cutters (Tool type: Plasma arc welding machine)
- Plumb bobs (Tool type: Plumb bobs)
- Pneumatic hammers (Tool type: Pneumatic hammer)
- Portable welding equipment (Tool type: Spot welding machine)
- Power drills (Tool type: Power drills)
- Power grinders (Tool type: Power grinders)
- Power sanders (Tool type: Power sanders)
- Power saws (Tool type: Power saws)
- Power wrenches (Tool type: Impact wrenches)
- Precision grinders (Tool type: Power grinders)
- Precision levels (Tool type: Levels)
- Precision squares (Tool type: Squares)
- Pressure gauges (Tool type: Pressure or vacuum recorders)
- Programmable logic controllers PLC (Tool type: Microcontrollers)
- Pry bars (Tool type: Pry bars)
- Punch presses (Tool type: Drill press or radial drill)
- Punches (Tool type: Punches or nail sets or drifts)
- Putty knives (Tool type: Putty knives)
- Radial drills (Tool type: Drill press or radial drill)
- Ratchet sets (Tool type: Ratchets)
- Reamers (Tool type: Hand reamer)
- Reciprocating machinery combustion analyzers (Tool type: Catalytic combustion analyzers)
- Rigging equipment (Tool type: Slings)
- Riveting tools (Tool type: Rivet tools)
- Robotic teach pendants (Tool type: Welding robots)
- Rotating brushes (Tool type: Wire brushes)
- Rubber mallets (Tool type: Rubber mallet)
- Rulers (Tool type: Rulers)
- Sandblasters (Tool type: Pneumatic sanding machines)
- Scalers (Tool type: Power sanders)
- Scissor lifts (Tool type: Scissor lift or lift table)
- Scrapers (Tool type: Scrapers)
- Screw pitch gauges (Tool type: Pitch measuring instruments)
- Screwdrivers (Tool type: Screwdrivers)
- Shaping machines (Tool type: Shaper cutter)
- Shielded arc welding tools (Tool type: Shielded metal arc welding or stick welding machine)
- Side cutting pliers (Tool type: End cut pliers)
- Single-cut mill saw files (Tool type: Mill saw file)
- Sledgehammers (Tool type: Sledge hammer)
- Socket wrench sets (Tool type: Socket sets)
- Soldering irons (Tool type: Soldering iron)
- Space gauges (Tool type: Thickness measuring devices)
- Spot welders (Tool type: Spot welding machine)
- Squares (Tool type: Squares)
- Staging platforms (Tool type: Platform lift)
- Steam cleaning equipment (Tool type: Pressure or steam cleaners)
- Steel wedges (Tool type: Wedges)
- Straightedges (Tool type: Straight edges)
- Strobe tachometers (Tool type: Tachometers)
- Stud drivers (Tool type: Anchor setting tools)
- Tachometers (Tool type: Tachometers)
- Tape measures (Tool type: Tape measures)
- Telescoping gauges (Tool type: Telescoping gauge)
- Thickness gauges (Tool type: Thickness measuring devices)
- Threading devices (Tool type: Threading machine)
- Transit levels (Tool type: Level sensors or transmitters)
- Tungsten inert gas TIG welding equipment (Tool type: Tungsten inert gas welding machine)
- Turning lathes (Tool type: Horizontal turning center)
- Utility knives (Tool type: Utility knives)
- Vacuum gauges (Tool type: Vacuum gauges)
- Vacuum lifts (Tool type: Suction cups)
- Vernier instruments (Tool type: Calipers)
- Vibration analyzers (Tool type: Vibration testers)
- Vises (Tool type: Bench vises)
- Voltmeters (Tool type: Voltage or current meters)
- Welding lenses (Tool type: Safety glasses)
- Welding shields (Tool type: Welding masks)
- Welding tip dressers (Tool type: Welding tip dresser or accessories)
- Wire cutters (Tool type: Wire cutters)
- Workshop cranes (Tool type: Workshop cranes)